F
F
F
F
F
F
################0F
###############00F
##############000F
#############0000F
############00000F
###########000000F
##########0000000F
#########00000000F
########000000000F
#######0000000000F
######00000000000F
#####000000000000F