F
F
F
F
F
###S0000G00000###F
####0000G000S####F
#####S00G000#####F
######00G0S###F
#######SG0F
########GF
########GF
#######SG0F
#####S00G000#####F
####0000G000S####F
###S0000G00000###F